1111111111
100000C001
1E000000P1
1111111111