111111111111111111111111111111111111111111
10P1000E10C10C0CC00C1CCC0100C0C01C00C00001
1C1CC000011C0000010000000011C000C0C000C011
1C0C00000CCCC000000000011000C0000100000101
10C0CC000010C00C00C1C0010C00000C00000C0C01
100C0000000001C1000010C0C00C0100010C1C0101
1100C0100000000C0000100000001000000C00C001
10C00011C00C0C0CC1C00C0C10CC0000C000C00001
1001C00000CC010C00001C00000C00CC0C00C00001
1100C000C0000CC000C00000C00C010101000C0001
111CC00C000C0CCC000C000C000100C00010C00001
1CC000C00C00000C0C00000C00101C001C0011CCC1
1C0001000101C0C00C00C11C010000000C010000C1
10000C0000C0C001000CC000C000000C00C00C0C01
10CC0C0CC0C000C0000C0C0C000C0000000C0CCC01
100C01C000C0C000C00C01C11CC0C0000CC0C00001
10C0CCC00C0C01000CC00CC010010C000CC0000C01
1C0000100C000C0000C0011C00010000C010000C01
1000000000C0000000011000C000C0010C001CC101
1C10000C10010000C100000C00C00000000000CC01
10CC0C0CCC00001000C000100000CCCC100C000001
1100000100C00000CC0000C00000000000C0000011
1000000C01CC000C0CC0C10000010CCC0CC00CC0C1
1000001CC010001C000000C0010000C000C0000001
1001C0C000000000000C0101C000000C000C0CCCC1
1CC00C100000000C00C00000CC00000001100C0001
10000C0C1CC00C00010CCCCC000C0000001CC00011
1C0C0C0CC000000C10000000000000000CC00000C1
1000C00000CC0000000C0000000C000C0C0C00C001
100C0100000CC000CCC0000CC01000000C00CC0101
10C01C00C0101C00000C00000000C000CC00000001
1000C0CC00CC0000CC0000010C1001C0CC000C00C1
1C00000C0C0C11CC0000C0C0C0000001CC00C01001
10000100C0000C0CC0000C000CC000001C00001001
101C0000C00000CC110C100C0000C000C0000C0001
1000C00CC1C0CC100000100000CC00C0C000000C01
1C000C00000000C000C0100CCCC01C00100C010001
1C000C000000010000010000000100CC1000000C01
1001CC0000C000011C000CCC000CC0C0000C000101
10CCC000C0C010C00C00C00C000000110000000CC1
1000C0000CC010000C000CC0C000000001CCCCCCC1
111111111111111111111111111111111111111111
