111111111111111111111111111111111111111111111
111000E0C1000001010CCCP00010C0000000C000CCCC1
1000CC00001000CCCC01C000C0CC0010C00000C00C001
1C0C1000C01000CC0CCC011C0C0CC000C0000100C00C1
1C00CC0000100000C00000000000C00CC000000C0C0C1
1000000C0CCC00010C00000C00CCCCCCC00CC0C00C001
10000C0000000CC000CC00010000C00010000C00000C1
1CCC000000C00C000000000C10001C1C0000010000C01
10001000010000000000000CC0000CCCC1C11C000C001
10000000C01CC00C000C0CC00C010001100000C0C00C1
1C0001101C000C0C00C0C00100C00C0C000100C010001
10C000C000000C0000000000C1001CC00C000C0000001
101C0C10C010C0000C00010C01C0010C0C00C00C00001
10CCC0CC0C001C0C0010CCC00C00CC00C0CC000000C11
1C1C00C0010C100C0CC1C000000CCC00C0C0000C00C11
111C010CCC0CC00C100C010000CC0C01000C010CCCCC1
100C0C000C0001000C0C000C000C00C0C000C0000CC01
1C0CCC0C0C00C00CC000000C0C000C00C00CC00CC0001
1C0C0C0000CCC0101000CC00C0000C0CC01C00C00C1C1
11C0000CCC0CCCC00C0CC000C00000100000C0000C101
100C00100000000C0CC00CC0C01CCC011000010C0C101
10C000000CC00C0000011000C0000000000010C000001
1CC00CC010C100000CC010C0100C000CC00CC0CC00001
1000CC000CC00000000C0000C000CCC01CC0C01000CC1
1100C00000000000C00000001C1C00C00CC01010000C1
101100C000CC00CC0C0000000C00000000C1CC0000001
111111111111111111111111111111111111111111111
