11111111111111111111111111111
10P11EC00CC0C0CC0CCCC0C00PC01
100000CCC0C0000C010C001000C01
100CCCC00010C10C000000C010001
100C1C0000011C0C0100000000C01
100C0000C100CC001CC0C01000001
10C01C0CCCCCC0C1CC00C0C01C001
1000000C00000C000000000C01001
1000C00CC00000000C0C00C010001
10C001000C000100C10C100000001
110C100000CC000C0C000C0000C01
100C000C0000C00CC100C0000CC01
1C10C00000C001001C10000CC1C01
10C000CC01000C00CC00C0C0C1111
1C00CC0CC000CC1000000000100C1
10000C0000001C0C0000CC10000C1
11C00C00000000100000000000CC1
100010000C00C0C00C00CC0000C01
10C0C00CC00C0000C000000011C01
10C00C0000000000C01C10100C001
1CC0010CC00C0000C010000000011
10100C00000CC00C1000C00000001
11111111111111111111111111111
