1111111111111111
1000000P10000001
100000000000E001
1CCCCC0C1CCCCCC1
1CCC00CCCCCCCCC1
1CCCCCCCCCC111C1
1CCCC00000CCCCC1
1CCCCCCCCCCCC1C1
1CCC1CC1CCCC1CC1
1CCCCCC1CCC1CCC1
1CCCCC1CCCCC00C1
1CCCCCCCCCCC0CC1
1CCC11111C1CC1C1
1CCCCCC1CCCCCCC1
1CCCCC000001CCC1
1CC0CCCCCCCCCCC1
1111111111111111