11111111111111111111
10P00000000000C000C1
1000ECP00C0111000001
10010000C00CCC00C001
111C1000C0000000CCC1
100C00C001CCC1000011
10CC0C0CC0C000000CC1
1C10C1C000CC001000C1
1C00000000CC1C0000C1
100C1CC0CC0C000CC001
10C01C00010C001000C1
100C01100000C0000001
10C0001010C0100C0001
1000CC000011C00C0C11
11111111111111111111
