111111111111111
10C00C1C00C0001
1001000P00000C1
1000CCC0100EC01
10100C10000C111
101C00000CC0CC1
1000010C000CCC1
111111111111111
