1111111111111111111111111111111111111111
1E0000000C001000001010000000C10C101000C1
10C0CC0C0CC000C011P000C000000000000C0001
1C0100C000C00000000000C000C000CCCC00CC01
11C0010CC01CCC00011C0000C11C0000CC0000C1
101CC0C0CC0000C000C1001001CC00C00000C0C1
1000CCCC0000100000C0C10C010C0100C0100C01
1101CC0C001C0C00CC000000100011C0000010C1
1C000C0001C0C000000CCC0CC000001000CC0111
10C0100000CC0010C0000C000C00000CCC100001
1CCC1C00C00C01C001C01C100CCCC00000C0C001
1C000010000011000001000000C00CC0000CC101
1000CC000000C101000001C000CC010C00CCC0C1
100C00C10000C000C0001C0000CC010C00C00001
1C1CC000001000C0CCCC00C0C0C0001000C00C01
11000C000C0C00000CC00C000001C00000010001
1100CC00C00000C0000C000CC00100C00C100001
10C0000000000CC000C0C00C0C00C0000CC00001
10C0CCC0000C000000000000CC10C1CC00001001
1111111111111111111111111111111111111111
