111111111
100C000P1
10001C001
10EP00C01
111111111
