111111111111111111111111111111
100CP0000CC000000CC00CECCCCCC1
111111111111111111111111111111
