1111111111
100000C001
1E00C00P11
1111111111